16
5	1	6	5	1	1	1	1	1	6	5	1	1	1	1	6	
4	3	0	0	3	0	0	0	6	4	0	0	0	0	0	2	
4	6	4	2	5	0	0	0	0	0	0	7	4	0	0	2	
4	0	0	0	0	0	7	4	0	0	0	1	0	0	0	7	
4	0	0	0	0	0	1	0	0	0	0	0	0	0	0	6	
8	0	0	0	0	0	0	0	0	0	0	0	2	8	0	2	
5	0	2	8	0	0	0	0	0	0	3	0	0	1	0	2	
4	0	0	1	0	0	0	20	21	2	5	0	3	0	0	2	
4	0	0	0	0	0	0	22	19	0	0	2	5	0	0	2	
4	3	0	2	8	0	0	0	0	2	8	0	0	0	0	2	
4	6	4	0	1	0	0	0	0	0	1	0	0	0	0	7	
8	0	0	0	0	0	0	0	0	7	4	0	0	0	3	6	
5	0	0	0	0	3	0	0	0	1	0	0	0	0	6	10	
4	0	0	0	2	5	0	0	0	0	0	0	0	3	0	2	
4	0	7	4	0	0	0	0	0	0	0	0	2	5	0	2	
8	3	9	7	8	3	3	3	3	3	7	8	3	3	3	7
